10 5 9
\
999-999-999-999-999-0  -999-999-999-999-
0  -999-999-999-999-999-999-999-999-999-
999-999-999-999-999-999-999-999-999-999-
999-999-999-999-999-999-999-999-999-999-
999-999-999-0  -999-999-999-999-999-0  -
\
0  -999-999-999-0  -999-0  -999-999-999-
999-999-999-999-999-999-999-999-999-999-
0  -999-999-999-999-999-999-999-999-999-
999-999-999-999-999-999-999-999-999-0  -
999-999-0  -999-0  -999-999-999-0  -999-
\
999-0  -999-0  -999-999-999-0  -999-999-
999-999-999-999-999-999-999-999-999-999-
999-999-999-999-999-999-999-999-999-0  -
0  -999-999-999-999-999-999-999-999-999-
999-0  -999-999-999-0  -999-0  -999-999-
\
999-999-0  -999-999-999-999-999-0  -999-
999-999-999-999-999-999-999-999-999-0  -
999-999-999-999-999-999-999-999-999-999-
999-999-999-999-999-999-999-999-999-999-
0  -999-999-999-999-999-0  -999-999-999-
\
0  +0  +0  +0  +0  +0  +0  +0  +0  +0  +
0  +0  +0  +0  +0  +0  +0  +0  +0  +0  +
0  +0  +0  +0  +1  +0  +0  +0  +0  +0  +
0  +0  +0  +0  +0  +0  +0  +0  +0  +0  +
0  +0  +0  +0  +0  +0  +0  +0  +0  +0  +
\
999-999-999-999-999-0  -999-999-999-999-
0  -999-999-999-999-999-999-999-999-999-
999-999-999-999-999-999-999-999-999-999-
999-999-999-999-999-999-999-999-999-999-
999-999-999-0  -999-999-999-999-999-0  -
\
0  -999-999-999-0  -999-0  -999-999-999-
999-999-999-999-999-999-999-999-999-999-
0  -999-999-999-999-999-999-999-999-999-
999-999-999-999-999-999-999-999-999-0  -
999-999-0  -999-0  -999-999-999-0  -999-
\
999-0  -999-0  -999-999-999-0  -999-999-
999-999-999-999-999-999-999-999-999-999-
999-999-999-999-999-999-999-999-999-0  -
0  -999-999-999-999-999-999-999-999-999-
999-0  -999-999-999-0  -999-0  -999-999-
\
999-999-0  -999-999-999-999-999-0  -999-
999-999-999-999-999-999-999-999-999-0  -
999-999-999-999-999-999-999-999-999-999-
999-999-999-999-999-999-999-999-999-999-
0  -999-999-999-999-999-0  -999-999-999-
\