5 5 8
\
999-999-999-999-999-
999-999-999-999-999-
999-999-999-999-999-
999-999-999-999-999-
999-999-999-999-999-
\
999-999-999-999-999-
999-999-999-999-999-
999-999-999-999-999-
999-999-999-999-999-
999-999-999-999-999-
\
999-999-999-999-999-
999-999-999-999-999-
999-999-999-999-999-
999-999-999-999-999-
999-999-999-999-999-
\
999-999-999-999-999-
999-999-999-999-999-
999-999-999-999-999-
999-999-999-999-999-
999-999-999-999-999-
\
0  +0  +0  +0  +0  +
0  +0  +0  +0  +0  +
0  +2  -2  -2  -0  +
0  +0  +2  -0  +0  +
0  +0  +2  -0  +0  +
\
2  -2  -2  -2  -2  -
2  -2  -2  -2  -2  -
2  -2  -2  -2  -2  -
2  -2  -2  -2  -2  -
2  -2  -2  -2  -2  -
\
2  -2  -2  -2  -2  -
2  -2  -2  -2  -2  -
2  -2  -2  -2  -2  -
2  -2  -2  -2  -2  -
2  -2  -2  -2  -2  -
\
2  -2  -2  -2  -2  -
2  -2  -2  -2  -2  -
2  -2  -2  -2  -2  -
2  -2  -2  -2  -2  -
2  -2  -2  -2  -2  -

