5 5 5
\
999-999-999-999-999-
999-999-999-999-999-
999-999-999-999-999-
999-999-999-999-999-
999-999-999-999-999-
\
999-999-999-999-999-
999-999-999-999-999-
999-999-999-999-999-
999-999-999-999-999-
999-999-999-999-999-
\
999-999-999-999-999-
999-999-999-999-999-
999-999-999-999-999-
999-999-999-999-999-
999-999-999-999-999-
\
2  -2  -2  -2  -2  -
999-999-999-999-999-
999-999-999-999-999-
999-999-999-999-999-
999-999-999-999-999-
\
2  -2  -2  -2  -2  -
0  +0  +0  +0  +0  +
0  +0  +1  +0  +0  +
0  +0  +0  +0  +0  +
0  +0  +0  +0  +0  +
